[9][9][2][5][7][7][8][4][5][5]
[0][6][8][5][3][7][5][7][1][5]
[8][0][5][4][3][3][2][5][7][1]
[5][0][0][2][4][5][9][5][6][8]
[1][2][1][8][1][9][5][4][6][4]
[2][6][3][6][7][9][6][7][8][7]
[8][3][3][5][4][1][9][7][6][0]
[9][3][4][9][5][9][5][4][2][4]
[6][9][6][5][2][3][9][5][0][9]
[2][8][4][7][5][3][1][9][5][7]