[3][7][7][4][0][5][6][3][0][1][6][6][8][3][3][8][1][9][8][7][0][2][3][6][1][1][6][4][5][5]
[3][5][5][6][7][5][0][5][4][0][2][7][4][6][4][3][4][3][4][0][9][2][7][7][5][4][4][9][9][2]
[7][1][1][8][8][2][8][5][9][0][4][0][0][6][5][0][5][8][7][2][0][4][2][1][5][6][6][7][4][0]
[1][3][1][7][2][5][3][8][1][7][2][1][2][1][7][4][5][3][8][5][8][7][6][7][6][1][5][3][6][8]
[2][3][3][7][8][3][6][6][3][1][9][8][7][0][5][8][3][6][8][2][7][9][2][0][9][5][8][6][5][9]
[1][6][1][4][1][2][1][6][8][4][4][2][8][7][3][3][1][3][7][0][2][7][3][3][5][4][6][7][0][5]
[6][1][6][7][4][3][0][9][3][9][6][0][8][1][2][7][2][5][4][3][2][7][9][1][3][0][7][3][6][6]
[4][3][9][6][4][1][3][5][8][9][3][0][8][1][9][6][2][6][6][1][5][4][3][6][4][7][2][4][0][4]
[4][8][7][0][3][1][5][9][7][1][6][5][7][2][1][7][5][8][4][8][2][3][3][2][6][2][5][9][8][5]
[3][2][0][4][7][4][1][7][1][7][8][6][1][0][9][7][6][3][4][0][5][1][2][6][8][0][1][4][7][2]
[0][5][1][6][1][9][5][2][0][4][3][5][6][0][7][0][5]